wwwwwwwwwwwwwwwwwwwwwwwwww
wx--c------A----x--------w
w---------------------x--w
w--------w---------------w
w-x------w------x--------w
w--------w---------------w
w--------w---------------w
w--------w---x--------x--w
w--x-----w---------------w
w--------wwww------------w
w-------------------x----w
w---x------e-------------w
wwwwwwwwwwwwwwwwwwwwwwwwww