wwwwwwwwwwwwwwwwwwwwwwwwww
wx--c------A----x--------w
w---------------------x--w
w------------------------w
w-x-------------x--------w
w------------------------w
w---------c--------------w
w------------x--------x--w
w--x---------------------w
w------------------------w
w-------------------x----w
w---x------e-------------w
wwwwwwwwwwwwwwwwwwwwwwwwww