wwwwwwwwwwwwwwwwwwwwwwwwww
wx--c------A----x--------w
w---------------------x--w
w------------------------w
w-x-------------x--------w
w------------------------w
www-wwwwwwwwwwwwwwww--wwww
w------------x--------x--w
w--x---------------------w
w------wwwwwwwww---------w
w-------------------x----w
w---x------e-------------w
wwwwwwwwwwwwwwwwwwwwwwwwww